###############################
#..............#..#......#....#
#.........................##..#
#.......#..#..................#
#.............................#
#.............................#
#.............................#
#.............................#
#..........................#..#
#.............................#
#.............................#
#.............................#
#.............................#
#.............................#
#.............................#
#.............................#
#.............................#
#.........................#..##
#..............#.........#.#..#
#............#.#.........#....#
###############################
